NO ./imgs/wall64-no.xpm
SO ./imgs/wall64-so.xpm
WE ./imgs/wall64-we.xpm
EA ./imgs/wall64-ea.xpm

F 253,159,39
C 153,101,224

        1111111111111111111111111
        1000000000110000000000001
        1011000001110000bonjour001
        1001000000000000000000001
 11111111101100000111000000000000
 100000000011000001110111111111111
 11110111111111011100000010001
 111101111111 1011101010010001
 11000000110111011100N00010001
 1000000000000000110000010001
 10000000000000001101010010001
 110000111101010111110111100111    
 1111011  1110101 101111010001
 1111111  1111111 111111111111
